1111111111111
10000000000C1
1000011111111
1P0011E0010C1
1111111111111
