   11
11111111
100000C1
10000101
1P0011E1
1000110111
10000001
10000001
11111111
1
