11111111
100000C1
10000111
1P0011E1
10001111
10000001
10000001
11111111
