1111111111111111111111111111111111
1000C0000000000C00000C000000000001
1010010100100000101001000000010101
1010010010101010P01001000000010101
1E0000000C00C0000000000000000000C1
1100011111000000000011110000111111
1000000000000000000000000000000001
1111111111111111111111111111111111
