1111111111111111111111111111111111
1000C0000000000C00000C000000000001
101E010100100000101001000000010101
101001001010101000100100P000010101
100010000C00C0000000000000000000C1
1111111111111111111111111111111111
